10 10
..........
.x......x.
.x......x.
.x......x.
.x......x.
.x......x.
.x......x.
.xx.....x.
.xxx....x.
..........
