10 10
..........
.x......x.
.x......x.
.x......x.
.x......x.
.x..x...x.
.x......x.
.x......x.
.x......x.
..........
