s.........
.x......x.
.x......x.
.x......x.
.x......x.
.x......x.
.x....t.x.
.xx.....x.
.xxx....x.
..........