..........
.x......x.
.x.t....x.
.x......x.
.x......x.
.x..x...x.
.x....b.x.
.x......x.
.x......x.
..........