..........
.x......x.
.x.b....x.
.x......x.
.x......x.
.x..xx..x.
.x......x.
.x......x.
.x......x.
.........g